2
2.5 4 5
#####
#S    #
#    E#
#####
21 13 12
############
#S##          #E#
# ##      #   # #
# # # # #
### # # # #
# # # # #
# ## # # #
## # # # #
### # # # #
## # # # #
# ## # #
# # #
############